{
  "name": "실험실",
  "width": 11,
  "height": 11,
  "spawn": [5, 5],
  "fills": [
    [ 0, 0, 0, 0, 0, 0, 0, 0, 0, 0, 1],
    [ 0, 0, 0, 0, 0, 0, 0, 0, 0, 0, 1],
    [ 0, 0, 0, 0, 0, 0, 0, 0, 0, 0, 1],
    [ 0, 0, 0, 1, 1, 1, 1, 1, 0, 0, 1],
    [ 0, 0, 0, 1, 0, 0, 0, 1, 0, 0,-2],
    [ 0, 0, 0, 1, 0, 2, 0,-1, 0, 0,-2],
    [ 0, 0, 0, 1, 0, 0, 0, 1, 0, 0,-2],
    [ 0, 0, 0, 1, 1, 1, 1, 1, 0, 0, 1],
    [ 0, 0, 0, 0, 0, 0, 0, 0, 0, 0, 1],
    [ 0, 0, 0, 0, 0, 0, 0, 0, 0, 0, 1],
    [ 0, 0, 0, 0, 0, 0, 0, 0, 0, 0, 1]
  ],
  "ments": [
    "뭐라적지",
    "뭐라적지2"
  ]
}
